XXXXXXXXXXXXXXXXXXXXXXXXX
XGGGGGGGGGGGGGGGGGGGGGGGX
XGGGGGGGGGGGGWWWWWGGGGGGGX
XGGGGGGGGGGGGWWWWWGGGGGGGX
XGGGGGGGGGGGGWWWWWGGGGGGGX
XGGGGGGGGGGGGGGGGGGGGGGGX
XGGGGGGGXXXXGGGGGXXXXGGGGX
XGGGGGGGXXXXGGGGGXXXXGGGGX
XGGGGGGGGGGGGGGGGGGGGGGGX
XGGGGGGGGGGGGGGGGGGGGGGGX
XGGGGGGGGGGGGGGGGGGGGGGGX
XGGGGGGGGGGGGXXXXGGGGGGGGX
XGGGGGGGGGGGGXXXXGGGGGGGGX
XGGGGGGGGGGGGGGGGGGGGGGGX
XGGGGGGGGGGGGGGGGGGGGGGGX
XGGGGGGGGGGGGGGGGGGGGGGGX
XGGGGGGGGGGGGGGGGGGGGGGGX
XGGGGGGGGGGGGGGGGGGGGGGGX
XXXXXXXXXXXXXXXXXXXXXXXXX
